
SomaFM Groove Salad:
	Andain - You Once Told Me
	St. Germain - Sure Thing
	Thievery Corporation - Tower Seven
	Reef Project - Pacific Flying
	Yoshinori Sunahara - Rhodes Funky Dub (Interlude)
	Leggo Beast - The New Deal
	G.O.L. - Soma Holiday
	Gabor Deutsch - Sunday Morning
	Reef Project - Pacific Flying
	Baby Mammoth - Frank's Angels
	JP-Juice - Cette Planete (Sushi Club Remix)
	Fila Brazillia - The Light Of Jesus
	Murya - Carl's Last Interview
	Baby Mammoth - Frank's Angels
	Orb - Little Fluffy Clouds
	Alex Cortiz - Spiral Chilla- (Lift Off Two)
	Banco De Gaia - Tempra
	Panorama - Selene
	Momma Gravy - Codeine Covered Cocktail Nuts
	Capsula - To See I
	Emancipator - Land & Sea (Feat. Molly Parti)
	Jaffa - Legz
	Global Communication - 8:07 (Maiden Voyage)
	Sine - Between Seasons
	dZihan & Kamien - Slowhand Hussein
	Journeyman - Latneiro (Woob's Sunrise Dub)
	Franco Molinari - Volare
	Quantic - The 5th Exotic
	State Azure - Exile
	Solee - Legends (Slow Motion Mix)
	Nelson Vaz - In Your Room Tonight
	State Azure - Converging
	Franco Molinari - Volare

Groove Salad Classic (Early 2000s Ambient):
	William Orbit - Water From A Vine Leaf
	Dallam - I-sense
	The Quiet Boys - Everybody Loves The Sunshine
	Baby Mammoth - Frank's Angels
	Irresistible Force - Nepalese Bliss (Fila Brazilla)
	Bahia Oawi - A K Musique
	Air - All I Need (With Beth Hirsch)

The Trip: [SomaFM]:
	Laera - Maravilla (Original Mix)

Downtempo (Secret Agent - SomaFM):
	Goblin - La Via Della Droga (Seq.13 - Finale)

SomaFM Space Station:
	Tranquility Bass - Mya Yadana (Monkey Forest Medley)
	Morphem - 15 Seconds

Synphaera Radio (Space Music):
	Remote Vision - Survey Pilot
	K. Markov - Exotic Landscape
	Extraworld - Hypothetical Moon

Rádio Bossa Nova Brazil:
	SERGIO MENDES - DESAFINADO

Vaporwaves [SomaFM]:

Dance Wave Retro!:
	All about Dance before 2000!

Radio Paradise - Eclectic Mix:
	Cochemea - Mitote
	Kíla - Wandering Fish

- 0 N - New Wave on Radio:
	INXS - Suicide Blonde

WRIX Electric City Bluegrass:
	Backline - Shadow Drift
	Iron Horse - The Unforgiven
	Specail Consensus - Wild Montana Skies
	The King James Boys - He's Holding On To Me
	Atkins & Loudermilk - Swing Low Sweet Chariot
